##############################
#....#......#............#...#
#.*..#..#.........#...*......#
#.......#####..####......#...#
#...R#..#.........#R.....#...#
#..###..#.........###...##.*##
#...#.....*.............#....#
#...~....**.............#....#
#...~..............##...*....#
#...#...............#...*....#
#..~####..###...........###..#
#...........###**####~~##....#
###...####..#...........*....#
#...*...R~.......####..##.*..#
#........~.......#R.....~....#
##############################
